
R 1920 1080

NO wall3.xpm
SO wall1.xpm

WE wall2.xpm

EA wall4.xpm
S ./luffy.xpm
F  193,138,21
C 105,255, 243

        11111111          111111111111
       10000001          1000000000001  
      100000011          1000111100001
     10000001             111111110001
    10000001                    100001
    10000001                    100001
   10000011  1111              100001
  10000001  10001             100001
 1000000111110001111         100001
 1000000000000000001        100001
 1000000000000000001       1000001
 1111111111100001111      1000000111111
           100001         1000000000001
           100001         1111111110001
           100001                 10001
           1000011111111111111111111001
           1000000000000000000000000001
           1000000000000000001000000001
           1000000000000000000000000001
           10000000000000000000000000001
           100000000000000000N000001001
           111111111111111111111111111