R 1920 700

111111111111111
1000010000000101
1111000000101111
100000011111101
100000000000011
111110001211110111111111111111111111
100000000000001
111111111111111