R 1922 1282

NO wall1.xpm

SO wall2.xpm

WE wall3.xpm

EA wall4.xpm
S ./sprite.xpm
F  193,138,21
C 125,255, 243

        11111111          111111111111
       12222221          1222222222221  
      122222211          1222111122221
     12222221             111111112221
    12222221                    122221
    12222221                    122221
   12222211  1111              122221
  12222221  12221             122221
 1222222111112221111         122221
 1222222222222222221        122221
 1222222222222222221       1222221
 1111111111122221111      1222222111111
           122221         1222222222221
           122221         1111111112221
           122221                 12221
           12222111111111111111111111221
           12222222222222222222222222221
           1222222222222222221222222221
           1222222222222222222222222221
           12222222222222222222222222221
           122222222222222222N222221221                                    
           111111111111111111111111111