R 1920 1080

NO ./wall1.xpm	

SO  wall2.xpm

WE wall3.xpm

EA wall4.xpm

S ./sprite.xpm

F  193,138,21

C 125,255,243

        11111111         111111111111
       10000001          1000000000001  
      100000011          1000111100001
     10000001             111111110001
     10000001                    100001
    10000001                    100001         
   10000011  1111              100001
  10000001  10001             100001
 1000000111110001111         100001
 1000000000000000001        100001
 1000000000000000001       1000001
 1111111111100001111      10000000111111
11111111111111111111111111111111111111111
11111111111111111111111111111111111111
           100001         1000000000001
           100001         11111111100001
           100001                 10001
           10000111111111111111111111001
           10000000000000000000000000001
           10000000000000000120000000001
           10000000000020000000000000001
           1000000000000000000000000001
           100000000000000000N002010011                                     
           111111111111111111111111111