R 1920 1080

111111111111111
100001020000101
111100000010111
100000011111101
100000000000001
100000000000001
111110001111101
100000000000001
111111111111111