R   10 300

NO ./txt64-1.xpm
SO ./txt.644.xpm

WE ./txt64-2.xpm

EA ./txtxxx64-3.xpm

S ./luffy.xpm


F  48,14,28
C 48,14, 45






        11111111          111111111111
       10000001          1000000000001  
      100000011          1000111100001
     10000001             11111  1000N1 
    10000001                    100001
    10000001                    100001
   10000011  1111              100001
  10000001  10001             100001
 1000000111110001111         100001
 1000000000000000001        100001
 1000000000000000001       1000001
 1111111111100001111      1000000111111
           100001         1000000000001
           100001         1111111110001
           100001                 10001
           10000111111111111111111110001
           1000000000000000000000000001
           1000000000000000000000000001
           1000000000000000000000000001
           10000000000000000000000000001
           1000000000000000000000000001
           1111111111111111111111111111