R   1920 555

NO ./txt64-1.xpm

SO ./txt.644.xpm

WE ./txt64-2.xpm

EA ./txtxxx64-3.xpm

S ./luffy.xpm


F  48,14,28




C 48,14,28

1111111111111111
10000100000000011
11111111111111111