R 1920 1080






F  48,               14 ,        28

111111111111111
1000010000000101
1111000000101111
100000011111101
100000000000011
1111100012111101
1000010000000001
111111111111111